11111111111111111
1C000000000C000E1
1C111111111111111
10000000000000001
111111111111111C1
1P000000000000001
11111111111111111